nachdenken über+Akk. :: думать, размышлять
zugeben :: добавлять
vorkommen :: встречаться
hindurch :: после существительного в течение
dastehen :: находиться, быть
die Unterredung :: (деловой) разговор
wütend :: яростный, свирепый
wahnsinnig :: безумный, помешанный
die Eifersucht :: ревность
die Brücke :: мост
steif :: жесткий, негнущийся 
entgültig :: окончательно
trüb(e) :: мутный, тусклый
widerlich :: отталкивающий, неприятный
deutlich :: ясный, отчётливый
die Weltauffassung :: мировоззрение
gefährlich :: опасный
die Kiefer :: сосна
kriegen :: получить
nämlich :: тот (же) самый
der Schund :: ерунда
das Haustier :: домашнее животное
der Vergleich :: сравнение
treu :: надежный, верный
der Gashebel :: акселератор
drücken :: давить, жать
die Geschwindigkeit :: скорость
sich bewegen :: двигаться
waldig :: лесистый
der Abhang :: склон, обрыв
barsch :: резкий
saumäßig :: ужасный, свинский
verletzten :: оскорблять, задевать